███████████████
█S█   █   █   █
█ ███ █ █ █ ███
█   █   █     █
█ ███ ███ ███ █
█     █     █ █
███ █ █ ███ █ █
█       █     █
█ ███ █████████
█ █   █     █ █
█ █ █ █ █ █ █ █
█   █   █   █ █
█ ███ ███ ███ █
█ █     █    G█
███████████████
