█████████████████████
█S█   █ ████████   G█
█  ██   █      █ █ ██
█ █ █ █ █ ████ █ █  █
█   █ █ █    █ █ ████
██ █   █ █ █ █      █
██   █ █ █ ██████████
███ █               █
█   █ █████████████ █
███ ███      █ ████ █
███   █ ████ █      █
███   █ ███████████ █
█   █ █             █
█████████████████████