██████████████████████████████
█S  █   █   █     █       █  █
███ █ █ █ ███ ██ ██ ███ █ █ ██
█   █   █     █   █   █ █    █
█ █████ █████ █ ███ ███ ███ ██
█ █ █   █   █ █   █   █ █    █
█ █ █ █████ █ ███ █ █ █ █ ████
█   █           █ █ █ █      █
███ █ █ ███ █████ █ █ █ ███ ██
█   █ █ █ █ █       █   █ █  █
█ █████ █ █ █ ███ █████ █ █ ██
█ █   █   █   █ █     █      █
█ █ █ █ █████ █ ███ █ ███ ████
█   █   █ █   █   █ █ █      █
█ █████ █ █ ███ █ ███ █ ███ ██
█     █ █   █   █     █      █
█ █ █ █ █ █ █ █ █ █ █ █ █ █ G█
██████████████████████████████
