███████████████
█S            █
█ █ █ █ █ █ █ █
█             █
█ █ █ █ █ █ █ █
█             █
█ █ █ █ █ █ █ █
█             █
█ █ █ █ █ █ █ █
█             █
█ █ █ █ █ █ █ █
█             █
█ █ █ █ █ █ █ █
█            G█
███████████████
