██████████████████████████████
█                            █
█ █ █ █ █ █ █ █ █ █ █ █ █ █ ██
█                            █
█ █ █ █ █ █ █ █ █ █ █ █ █ █ ██
█                            █
█ █ █ █ █ █ █ █ █ █ █ █ █ █ ██
█                            █
█ █ █ █ █ █ █ █ █ █ █ █ █ █ ██
█                            █
█ █ █ █ █ █ █ █ █ █ █ █ █ █ ██
█                            █
█ █ █ █ █ █ █ █ █ █ █ █ █ █ ██
█                            █
█ █ █ █ █ █ █ █ █ █ █ █ █ █ ██
█                            █
█ █ █ █ █ █ █ █ █ █ █ █ █ █ ██
██████████████████████████████
