███████████████
█G            █
█ █ █ █ █ █ █ █
█             █
█ █ █ █ █ █ █ █
█             █
█ █ █ █ █ █ █ █
█             █
█ █ █ █ █ █ █ █
█             █
█ █ █ █ █ █ █ █
█             █
█ █ █ █ █ █ █ █
█            S█
███████████████
